NO ./Textures/n.xpm
SO ./Textures/s.xpm
WE ./Textures/w.xpm
EA ./Textures/e.xpm

F 255,255,255
C 222,243,246





111111111111
1W000000111111111
11100000011
10000000011
100010000011111
1001 10000000001
100010000000001
111111111111111