NO ./Textures/n.xpm
SO ./Textures/s.xpm
WE ./Textures/w.xpm
EA ./Textures/e.xpm

F 0,0,0
C 255,192,203





11111111111
10000000001
10000000001
1000E000001
100010000011111
1001 1000000001
100010000000001
111111111110111
        1000001
        1000001
        1111111