NO ./texturesCave/n.xpm
SO ./texturesCave/s.xpm
WE ./texturesCave/w.xpm
EA ./texturesCave/e.xpm

F 40,40,40
C 90,90,90





111111111111111111111
1E0000000000000000001
111101111111011111101
100001000001000000001
101101011101111111101
101000010001000000001
101111111101011111101
100000000001000000001
111111011111011111101
100000000000000000001
111111111111111111111
