NO ./texturesCave/n.xpm
SO ./texturesCave/s.xpm
WE ./texturesCave/w.xpm
EA ./texturesCave/e.xpm

F 40,40,40
C 90,90,90





11111111111
1E000000001
11101110111
10001000001
10101011101
10100010101
10111110101
10000000101
11111110101
10000000101
11111111111
