NO ./texturesLand/n.xpm

SO ./texturesLand/s.xpm

WE ./texturesLand/w.xpm

EA ./texturesLand/e.xpm

F 80,130,12
C 255,0,1 
111111111111111111111111111111111111111111
1N1
111
