NO ./texturesLand/n.xpm
SO ./texturesLand/s.xpm
WE ./texturesLand/w.xpm
EA ./texturesLand/e.xpm

F 80,130,40
C 80, 150, 255




111111111111111111111
10E000000000000000001
100011110000111100001
100010000000000100001
100010111001110100001
100010100000010100001
100010100000010100001
100010111111110100001
100010000000000100001
100011110000111100001
100000000000000000001
111111111111111111111
