NO ./texturesLand/n.xpm
SO ./texturesLand/s.xpm
WE ./texturesLand/w.xpm
EA ./texturesLand/e.xpm

F 80,130,40
C 80, 150, 255





11111111111
10000000001
10000000001
10000000001
10000000001
1000W0000001
10000000001
10000000001
10000000001
10000000001
11111111111
