NO ./texturesNether/n.xpm
SO ./texturesNether/s.xpm
WE ./texturesNether/w.xpm
EA ./texturesNether/e.xpm

F 30,20,20
C 80,20,20





11111111111
10000000001
10001111001
10001000001
10001000001
1000S000001
10000000001
10011110001
10000000001
10000000001
11111011111
11111011111
10000000001
10001111001
10001000001
10001000001
10000000001
10000000001
10011110001
10000000001
10000000001
11111111111