NO ./texturesNether/n.xpm
SO ./texturesNether/s.xpm
WE ./texturesNether/w.xpm
EA ./texturesNether/e.xpm

F 30,20,20
C 80,20,20





111111111111111111111
100000000000000000001
101111111111111110101
101000000000000010101
101011111111111010101
10101000000S001010101
101010111111101010101
101010100000101010101
101011111111101010101
100000000000000000001
111111111111111111111
